%%%%%%%%
%.    .%
%      %
% %%%% %
% %    %
% % %%%%
%P%   .%
%%%%%%%%